1111111111
1P00000001
1011100001
1000001111
10C00000E1
1111111111
