1111111111
1E0000C001
100V00VVV1
1C001CVCP1
1111111111