1111111111
1E0000C001
100V000V11
1C001C1CP1
1111111111