1111111111
1E0000C001
1000000011
1C001C1CP1
1111111111