1111111111
1E0000C0P1
1111100001
1000001011
1C001C1C01
1111111111