1111111111
1E0000C001
1111100001
10000P1011
1C001C1C01
1111111111