1111111111
100000C001
1E00000001
1000000101
1C001C1CP1
1111111111