1111111111
1EP000C001
1100000001
1000001101
1C001C1C01
1111111111