1111111111
100000C001
1E00000001
100000P101
1C001C1C01
1111111111